//MAP CONVERTED BY dmm2tgm.py THIS HEADER COMMENT PREVENTS RECONVERSION, DO NOT REMOVE
"a" = (
/obj/machinery/door/airlock/highsecurity{
	name = "IS-0083"
	},
/turf/open/floor/eighties,
/area/ruin/space/has_grav/collapsing_rift_arcade)
"c" = (
/obj/machinery/computer/arcade/collapsing_rift{
	dir = 8
	},
/turf/open/floor/black,
/area/ruin/space/has_grav/collapsing_rift_arcade)
"f" = (
/obj/structure/sign/warning/directional/north,
/turf/open/floor/iron/airless,
/area/ruin/space/has_grav/collapsing_rift_arcade)
"g" = (
/obj/effect/decal/cleanable/dirt,
/turf/open/floor/black,
/area/ruin/space/has_grav/collapsing_rift_arcade)
"n" = (
/turf/closed/wall,
/area/ruin/space/has_grav/collapsing_rift_arcade)
"p" = (
/obj/effect/decal/cleanable/dirt/dust,
/turf/open/floor/black,
/area/ruin/space/has_grav/collapsing_rift_arcade)
"t" = (
/turf/template_noop,
/area/template_noop)
"v" = (
/turf/open/floor/iron/airless,
/area/ruin/space/has_grav/collapsing_rift_arcade)
"B" = (
/obj/effect/decal/cleanable/dirt/dust,
/obj/effect/decal/cleanable/robot_debris/down,
/turf/open/floor/eighties,
/area/ruin/space/has_grav/collapsing_rift_arcade)
"E" = (
/turf/closed/wall/rust,
/area/ruin/space/has_grav/collapsing_rift_arcade)
"F" = (
/obj/structure/chair/sofa/corp/left{
	dir = 4
	},
/obj/effect/decal/cleanable/dirt/dust,
/turf/open/floor/eighties,
/area/ruin/space/has_grav/collapsing_rift_arcade)
"J" = (
/obj/structure/chair/sofa/corp/right{
	dir = 4
	},
/obj/effect/decal/cleanable/dirt/dust,
/turf/open/floor/eighties,
/area/ruin/space/has_grav/collapsing_rift_arcade)
"K" = (
/obj/structure/chair/wood{
	dir = 8
	},
/obj/effect/decal/cleanable/dirt/dust,
/turf/open/floor/eighties,
/area/ruin/space/has_grav/collapsing_rift_arcade)
"N" = (
/obj/structure/table/wood,
/obj/effect/decal/cleanable/cobweb,
/obj/effect/decal/cleanable/dirt/dust,
/obj/item/reagent_containers/cup/glass/coffee_cup{
	pixel_y = 3
	},
/turf/open/floor/eighties,
/area/ruin/space/has_grav/collapsing_rift_arcade)
"V" = (
/turf/open/floor/plating,
/area/ruin/space/has_grav/collapsing_rift_arcade)
"Y" = (
/obj/structure/lattice,
/turf/template_noop,
/area/ruin/space/has_grav/collapsing_rift_arcade)

(1,1,1) = {"
t
t
t
t
Y
t
t
t
"}
(2,1,1) = {"
t
t
t
t
Y
t
t
t
"}
(3,1,1) = {"
t
Y
Y
t
E
t
V
t
"}
(4,1,1) = {"
n
E
E
n
n
V
v
t
"}
(5,1,1) = {"
n
N
F
J
n
v
v
t
"}
(6,1,1) = {"
E
g
B
p
a
v
V
t
"}
(7,1,1) = {"
E
c
p
K
n
f
V
t
"}
(8,1,1) = {"
E
n
n
n
E
V
V
Y
"}
(9,1,1) = {"
n
t
Y
t
n
V
t
t
"}
(10,1,1) = {"
n
Y
Y
t
t
Y
t
t
"}
(11,1,1) = {"
t
t
t
t
t
Y
t
t
"}
