//MAP CONVERTED BY dmm2tgm.py THIS HEADER COMMENT PREVENTS RECONVERSION, DO NOT REMOVE
"a" = (
/turf/closed/wall/mineral/titanium/shuttle_wall/arrivals{
	icon_state = "1,3"
	},
/area/misc/condo)
"b" = (
/turf/closed/wall/mineral/titanium/shuttle_wall/arrivals{
	icon_state = "11,4"
	},
/area/misc/condo)
"c" = (
/turf/closed/wall/mineral/titanium/shuttle_wall/arrivals{
	icon_state = "0,2"
	},
/area/misc/condo)
"d" = (
/turf/closed/wall/mineral/titanium/shuttle_wall/window/arrivals{
	icon_state = "8,0"
	},
/area/misc/condo)
"e" = (
/turf/open/floor/iron/shuttle/arrivals,
/area/misc/condo)
"f" = (
/turf/closed/wall/mineral/titanium/shuttle_wall/arrivals{
	icon_state = "11,0"
	},
/area/misc/condo)
"g" = (
/obj/structure/chair/sofa/bench/right{
	dir = 1
	},
/turf/open/floor/iron/shuttle/arrivals,
/area/misc/condo)
"h" = (
/turf/closed/wall/mineral/titanium/shuttle_wall/arrivals{
	icon_state = "12,4"
	},
/area/misc/condo)
"i" = (
/turf/closed/wall/mineral/titanium/shuttle_wall/arrivals{
	icon_state = "0,1"
	},
/area/misc/condo)
"j" = (
/obj/machinery/status_display/evac/directional/south,
/obj/machinery/door/airlock/silver/glass,
/turf/open/floor/iron/shuttle/arrivals,
/area/misc/condo)
"k" = (
/turf/closed/wall/mineral/titanium/shuttle_wall/arrivals{
	icon_state = "0,0"
	},
/area/misc/condo)
"l" = (
/turf/closed/wall/mineral/titanium/shuttle_wall/window/arrivals{
	icon_state = "7,4"
	},
/area/misc/condo)
"m" = (
/turf/closed/wall/mineral/titanium/shuttle_wall/window/arrivals{
	icon_state = "4,0"
	},
/area/misc/condo)
"n" = (
/turf/closed/wall/mineral/titanium/shuttle_wall/arrivals{
	icon_state = "6,4"
	},
/area/misc/condo)
"o" = (
/turf/closed/wall/mineral/titanium/shuttle_wall/arrivals{
	icon_state = "12,0"
	},
/area/misc/condo)
"p" = (
/obj/structure/closet/shuttle/emergency/white,
/turf/open/floor/iron/shuttle/arrivals,
/area/misc/condo)
"q" = (
/obj/machinery/light/directional/west,
/turf/open/floor/iron/shuttle/arrivals{
	icon_state = "sign_2"
	},
/area/misc/condo)
"r" = (
/obj/structure/closet/crate/bin,
/turf/open/floor/iron/shuttle/arrivals{
	icon_state = "sign_1"
	},
/area/misc/condo)
"s" = (
/obj/machinery/light/directional/north,
/obj/machinery/computer/terminal,
/turf/open/floor/iron/shuttle/arrivals,
/area/misc/condo)
"t" = (
/turf/closed/wall/mineral/titanium/shuttle_wall/arrivals{
	icon_state = "3,3"
	},
/area/misc/condo)
"u" = (
/obj/structure/chair/sofa/bench/right,
/turf/open/floor/iron/shuttle/arrivals,
/area/misc/condo)
"w" = (
/turf/closed/wall/mineral/titanium/shuttle_wall/arrivals{
	icon_state = "12,3"
	},
/area/misc/condo)
"x" = (
/obj/machinery/status_display/ai/directional/south,
/obj/machinery/door/airlock/silver/glass,
/turf/open/floor/iron/shuttle/arrivals,
/area/misc/condo)
"y" = (
/turf/closed/wall/mineral/titanium/shuttle_wall/arrivals{
	icon_state = "0,3"
	},
/area/misc/condo)
"z" = (
/turf/closed/wall/mineral/titanium/shuttle_wall/arrivals{
	icon_state = "12,1"
	},
/area/misc/condo)
"A" = (
/turf/closed/wall/mineral/titanium/shuttle_wall/arrivals,
/area/misc/condo)
"B" = (
/turf/closed/wall/mineral/titanium/shuttle_wall/arrivals{
	icon_state = "3,0"
	},
/area/misc/condo)
"C" = (
/turf/closed/wall/mineral/titanium/shuttle_wall/window/arrivals{
	icon_state = "4,4"
	},
/area/misc/condo)
"D" = (
/obj/machinery/light/directional/south,
/turf/open/floor/iron/shuttle/arrivals{
	icon_state = "sign_3"
	},
/area/misc/condo)
"E" = (
/turf/closed/wall/mineral/titanium/shuttle_wall/arrivals{
	icon_state = "12,2"
	},
/area/misc/condo)
"F" = (
/turf/closed/indestructible/hoteldoor/fakedoor/external_airlock,
/area/misc/condo)
"G" = (
/obj/structure/chair/sofa/bench/left{
	dir = 1
	},
/turf/open/floor/iron/shuttle/arrivals,
/area/misc/condo)
"H" = (
/obj/machinery/light/directional/east,
/turf/open/floor/iron/shuttle/arrivals{
	icon_state = "sign_2"
	},
/area/misc/condo)
"I" = (
/turf/closed/wall/mineral/titanium/shuttle_wall/arrivals{
	icon_state = "9,3"
	},
/area/misc/condo)
"J" = (
/turf/closed/wall/mineral/titanium/shuttle_wall/arrivals{
	icon_state = "2,4"
	},
/area/misc/condo)
"K" = (
/turf/closed/wall/mineral/titanium/shuttle_wall/arrivals{
	icon_state = "1,0"
	},
/area/misc/condo)
"L" = (
/turf/closed/wall/mineral/titanium/shuttle_wall/arrivals{
	icon_state = "9,1"
	},
/area/misc/condo)
"M" = (
/turf/closed/wall/mineral/titanium/shuttle_wall/arrivals{
	icon_state = "6,0"
	},
/area/misc/condo)
"N" = (
/turf/closed/wall/mineral/titanium/shuttle_wall/window/arrivals{
	icon_state = "7,0"
	},
/area/misc/condo)
"O" = (
/turf/closed/wall/mineral/titanium/shuttle_wall/window/arrivals{
	icon_state = "5,4"
	},
/area/misc/condo)
"P" = (
/turf/closed/wall/mineral/titanium/shuttle_wall/arrivals{
	icon_state = "1,4"
	},
/area/misc/condo)
"Q" = (
/turf/closed/wall/mineral/titanium/shuttle_wall/arrivals{
	icon_state = "11,3"
	},
/area/misc/condo)
"R" = (
/turf/open/floor/iron/shuttle/arrivals{
	icon_state = "sign_1"
	},
/area/misc/condo)
"S" = (
/turf/closed/wall/mineral/titanium/shuttle_wall/arrivals{
	icon_state = "0,4"
	},
/area/misc/condo)
"T" = (
/turf/closed/wall/mineral/titanium/shuttle_wall/arrivals{
	icon_state = "9,0"
	},
/area/misc/condo)
"V" = (
/turf/closed/wall/mineral/titanium/shuttle_wall/window/arrivals{
	icon_state = "5,0"
	},
/area/misc/condo)
"W" = (
/turf/closed/wall/mineral/titanium/shuttle_wall/arrivals{
	icon_state = "9,4"
	},
/area/misc/condo)
"X" = (
/turf/closed/wall/mineral/titanium/shuttle_wall/arrivals{
	icon_state = "3,4"
	},
/area/misc/condo)
"Y" = (
/turf/closed/wall/mineral/titanium/shuttle_wall/window/arrivals{
	icon_state = "8,4"
	},
/area/misc/condo)
"Z" = (
/obj/structure/chair/sofa/bench/left,
/turf/open/floor/iron/shuttle/arrivals,
/area/misc/condo)

(1,1,1) = {"
S
y
c
i
k
"}
(2,1,1) = {"
P
a
r
R
K
"}
(3,1,1) = {"
J
p
e
H
F
"}
(4,1,1) = {"
X
t
j
A
B
"}
(5,1,1) = {"
C
u
e
G
m
"}
(6,1,1) = {"
O
Z
e
g
V
"}
(7,1,1) = {"
n
s
e
D
M
"}
(8,1,1) = {"
l
u
e
G
N
"}
(9,1,1) = {"
Y
Z
e
g
d
"}
(10,1,1) = {"
W
I
x
L
T
"}
(11,1,1) = {"
X
p
e
q
F
"}
(12,1,1) = {"
b
Q
R
R
f
"}
(13,1,1) = {"
h
w
E
z
o
"}
